111111111111111111111111
100000000001000000000001
100P00000001000000000001
100000000000000100000001
100E00000000000100000001
100000000000000100000001
100000000000000100000001
100000000000000100000001
100000000011100100000001
100C00000010100100000001
100000000010100100000001
100000000000100100000001
111111111111111111111111
